11111111111111111111111111111
100000000111100000010000000E1
1111111000C0000000011100000C1
1111000000111000C000000000011
100C0001111000010010000110001
10000001111000000011100000111
1P00000C00000C000000000000001
11111111111111111111111111111